node id	input link	output link																														
1	2	3	2	5	2	7	2	1																				
1	2	7       2	3	8       5	8       1
1       8       5       8       1	8       3	8	7								
1	6	7	4	1	4	3	6	5
1	6	1	6	3	4	7	4	5																
2	7	9	7	8	12	11
2	7	11	12	9	12	8					
2	10	8	10	11	10	9																								
3	11	13	11	12	16	15
3	11	15	16	13	16	12     
3	14	12	14	15      14	13																										
4	15	19      22      17      15      16      22      21
4	15	17	15	21	22	19	22	16																								
4	20	21	20	19	18	16	18	17
4	20	16	20	17	18	19	18	21																	
5	21	25	21	22	28	23	28	27
5	21	23	21	27	28	25	28	22																	
5	24	22	24	23	26	27	26	25
5	24	25	24	27	26	22	26	23      
6	27	29	27	28	32	31
6	27	31	32	29	32	28				
6	30	28	30	31	30	29																						
7	31	35	38	33	31      32      38      37
7	31	33	31	37	38	32	38	35																							
7	34	32	36	37	34	33	36	35																				
7	34	37	34	35	36	32	36	33																								
8	37	41	44	39	37      38      44      43
8	37	39	37	43	44	41	44	38																								
8	40	38	40	39	42	41	42	43
8	40	41	40	43	42	38	42	39																
9	43	47	43	44	50	45	50	49
9	43	45	43	49	50	47	50	44																
9	46	44	46	45	48	49      48      47
9	46	47	46	49	48	44      48      45 
10	49	55	52	53	49	50	52	51																								
10	49	51	49	53	52      55      52      50
10      54      50      54      53      56      51      56      55
10      54      55      54      51      56      50      56      53
